1111111
10P1E01
1011101
101C101
1000001
1111111